Job,Machine1,Machine2,Machine3,Machine4,Machine5,Machine6,Machine7
1,3,2,2,4,3,2,1
2,2,1,4,3,2,1,4
3,4,3,3,2,4,3,2
4,3,2,1,4,3,2,1
5,2,4,3,1,2,4,3
6,3,2,4,1,3,2,4
7,4,3,2,5,2,3,4
8,2,1,3,4,4,1,3
9,3,4,2,3,1,4,2
10,1,3,4,2,5,3,4